...###
...........
.##..###..#
##........#
#...@..#..#
###..###..#
..#..#....#
.##.##...##
.#......##
.#.....##
.#######