...###
..##.#.####
.....###..#
##........#
#...@..#..#
.....###..#
..#..#....#
.##.##.#.##
........##
.#.....##
...#####